county_fips,state_po,Civilian_labor_force_2020,Employed_2020,Unemployed_2020,Unemployment_rate_2020,Median_Household_Income_2022,"Less than high school graduate, 2019-23","High school graduate (or equivalency), 2019-23","Some college or associate degree, 2019-23","Bachelor's degree or higher, 2019-23",CENSUS_2020_POP,"Joseph Biden Votes, 2020","Donald Trump Votes, 2020","Jo Jorgensen Votes, 2020","Green Party Votes, 2020","Other Votes, 2020","Total Votes, 2020"
36001,1,159599,148570,11029,6.9,76997,14567,45949,56250,96130,314848,99474,51081,1523,779,1870,154727
36003,1,19452,17943,1509,7.8,55466,2495,10438,9540,7317,46456,6048,14135,338,88,286,20895
36005,1,613070,514858,98212,16,45864,231663,266402,233903,205925,1472654,355374,67740,775,1420,7090,432399
36007,1,83619,76645,6974,8.3,60533,11764,38708,40376,40032,198683,47010,43800,1104,432,1148,93494
36009,1,33738,30661,3077,9.1,52383,5704,21229,15044,10940,77042,11879,22155,450,113,421,35018
36011,1,36143,33395,2748,7.6,64129,6087,17076,18687,13128,76248,16149,19512,399,185,515,36760
36013,1,54000,49387,4613,8.5,55644,8876,29205,28228,22218,127657,23087,34853,756,203,871,59770
36015,1,36033,32996,3037,8.4,56664,5328,19255,18154,15715,84148,16636,21922,560,117,476,39711
36017,1,22189,20716,1473,6.6,60755,3805,13931,9551,6475,47220,8290,13482,316,107,222,22417
36019,1,36208,33432,2776,7.7,65272,6484,17819,15876,14726,79843,18364,16514,279,121,359,35637
36021,1,30972,29126,1846,6,83533,4020,13287,12028,18050,61570,20386,14464,357,185,389,35781
36023,1,22854,21093,1761,7.7,58274,2655,9272,9010,8277,46809,10369,10789,295,113,326,21892
36025,1,19018,17692,1326,7,61424,3179,12303,8828,8853,44308,9143,13387,268,81,195,23074
36027,1,145036,134383,10653,7.3,90740,17317,52992,57099,83972,295911,81443,66872,1247,578,1749,151889
36029,1,446586,405707,40879,9.2,69888,50862,173751,199479,248289,954236,267174,197527,4439,1986,5661,476787
36031,1,16906,15574,1332,7.9,62376,2457,9581,7828,9052,37381,9947,8976,173,73,301,19470
36033,1,19507,17955,1552,8,59192,4245,11347,9931,7959,47555,9253,9668,173,77,249,19420
36035,1,22975,21075,1900,8.3,61512,4390,13686,12011,8073,53324,7931,15378,248,73,442,24072
36037,1,29610,27513,2097,7.1,68973,3115,15321,13472,9864,58388,9625,18876,456,109,365,29431
36039,1,20632,18984,1648,8,71433,4061,11870,9839,10491,47931,10346,14271,305,121,277,25320
36041,1,2199,2029,170,7.7,62149,442,1280,1301,1112,5107,1178,2225,41,7,38,3489
36043,1,28065,25851,2214,7.9,62197,3562,14602,15046,9706,60139,9937,18870,298,98,357,29560
36045,1,44233,40513,3720,8.4,58763,6491,23947,25040,19164,116721,17307,25629,537,186,470,44129
36047,1,1202125,1052319,149806,12.5,73244,292418,446123,346253,764053,2736074,703310,202772,2504,3978,7816,920380
36049,1,11644,10775,869,7.5,64452,1596,7903,5392,3586,26582,3824,8894,126,46,146,13036
36051,1,30352,28277,2075,6.8,75077,3096,13073,12778,12762,61834,12477,18182,460,128,409,31656
36053,1,33052,30557,2495,7.5,69851,3096,15575,14498,12910,68016,14807,18408,476,185,390,34266
36055,1,366956,336893,30063,8.2,68169,43279,120443,145810,216673,759443,225746,145661,4865,1529,5698,383499
36057,1,22517,20618,1899,8.4,58176,3928,12119,11159,7022,49532,7977,12745,242,87,195,21246
36059,1,712663,655369,57294,8,135528,76343,204149,218016,473504,1395774,396504,326716,3594,1924,9631,738369
36061,1,896451,811056,85395,9.5,95514,136464,148866,168389,806709,1694251,603040,85185,3329,2694,7157,701405
36063,1,99542,89502,10040,10.1,63565,12145,49424,49444,41401,212666,46029,56068,1133,371,1265,104866
36065,1,102757,94725,8032,7.8,63894,17606,47867,49454,44142,232125,41567,57180,1184,388,1377,101696
36067,1,224981,206935,18046,8,70939,26811,79231,94871,123843,476516,138894,90619,2554,1820,1799,235686
36069,1,55882,51990,3892,7,76601,5376,20867,24368,29943,112458,29025,29039,987,277,757,60085
36071,1,187228,172265,14963,8,88532,26700,72466,76077,83389,401310,84684,84996,1388,524,1713,173305
36073,1,17412,16007,1405,8.1,62900,3870,11996,8185,5102,40343,5587,12126,313,50,238,18314
36075,1,53129,48538,4591,8.6,59335,8026,29469,25210,17608,117525,21143,32138,697,284,590,54852
36077,1,27159,25275,1884,6.9,68962,3093,12049,10821,13287,58524,12975,14382,409,136,321,28223
36079,1,51374,47668,3706,7.2,112167,4791,17647,17730,30981,97668,24953,29283,411,162,509,55318
36081,1,1142439,1000240,142199,12.4,80180,293903,435024,370386,598760,2405464,569038,212665,2483,2969,7343,794498
36083,1,82193,76661,5532,6.7,80040,8252,28882,34015,42276,161130,40969,36500,1016,374,1103,79962
36085,1,221561,198280,23281,10.5,91582,39597,101569,80673,123573,495747,90997,123320,909,662,2011,217899
36087,1,156371,144312,12059,7.7,99839,25658,45118,49959,87859,338329,75802,73186,650,323,1420,151381
36089,1,43848,40394,3454,7.9,59451,7752,24038,21858,17541,108505,19361,24608,437,201,660,45267
36091,1,121791,113947,7844,6.4,93341,9952,42049,44945,75452,235509,68471,61305,1737,511,1532,133556
36093,1,78486,72431,6055,7.7,74206,8967,28899,33527,38542,158061,42465,30741,923,352,900,75381
36095,1,14831,13817,1014,6.8,67975,1729,7457,6982,5393,29714,5345,9903,282,75,205,15810
36097,1,8208,7524,684,8.3,63233,1219,4425,4237,3358,17898,3903,5621,130,51,94,9799
36099,1,15568,14350,1218,7.8,65354,3678,7706,6752,5770,33814,6914,8329,193,73,209,15718
36101,1,42794,39426,3368,7.9,60558,5433,23124,20414,17225,93584,15790,29474,570,164,518,46516
36103,1,781583,718094,63489,8.1,119253,101857,265633,276192,426656,1525920,368000,375821,4458,2066,7532,757877
36105,1,36583,33513,3070,8.4,63733,6884,16623,15701,16553,78624,15489,18665,247,123,608,35132
36107,1,22602,20901,1701,7.5,76197,2771,12406,10558,8855,48455,9634,14791,416,92,237,25170
36109,1,49677,46779,2898,5.8,72025,2535,10041,12491,36447,105740,33619,11096,474,365,494,46048
36111,1,87714,80952,6762,7.7,79340,11085,37570,35902,49768,181851,57970,37590,879,618,1103,98160
36113,1,31475,28911,2564,8.1,69849,4012,13854,14451,17109,65737,17642,17699,424,204,425,36394
36115,1,27668,25748,1920,6.9,67013,4382,18041,13219,9606,61302,11565,15941,340,128,282,28256
36117,1,43705,40589,3116,7.1,70917,5888,20369,22424,16691,91283,17456,26204,656,184,531,45031
36119,1,487399,448279,39120,8,108037,74220,124954,131927,366101,1004457,312371,144713,2569,1280,1332,462265
36121,1,18239,16919,1320,7.2,65526,3958,11289,8999,5406,40531,5073,13898,267,63,182,19483
36123,1,11814,11073,741,6.3,62637,2598,5849,4072,4179,24774,4219,6208,165,40,156,10788
42001,2,54836,51147,3689,6.7,76554,6866,30052,18762,18329,103852,18207,37523,810,0,0,56540
42003,2,646554,589554,57000,8.8,71973,40798,228685,227844,403248,1250578,429065,282324,8344,0,0,719733
42005,2,31823,28779,3044,9.6,57609,3365,23541,12448,9146,65558,8457,27489,424,0,0,36370
42007,2,83965,75522,8443,10.1,67135,6043,44648,37384,34755,168215,38122,54759,1241,0,0,94122
42009,2,24031,21924,2107,8.8,55517,3505,16890,8808,5707,47577,4367,23025,182,0,0,27574
42011,2,215733,195790,19943,9.2,72157,34165,108364,71601,79881,428849,92895,109736,2909,0,0,205540
42013,2,60263,55160,5103,8.5,57884,5911,39403,20848,20990,122822,17636,45306,653,0,0,63595
42015,2,28581,26491,2090,7.3,63529,3801,19788,9931,9023,59967,8046,21600,513,0,0,30159
42017,2,344795,316977,27818,8.1,105202,23823,128441,109156,204982,646538,204712,187367,4155,0,0,396234
42019,2,99766,92204,7562,7.6,81507,6084,44904,35289,54328,193763,37508,74359,1438,0,0,113305
42021,2,57178,51879,5299,9.3,54612,6783,42090,24501,21907,133472,21730,48085,759,0,0,70574
42023,2,2070,1818,252,12.2,50338,315,1748,1037,393,4547,634,1771,29,0,0,2434
42025,2,32070,29015,3055,9.5,64766,4694,21447,13213,8840,64749,11212,21984,433,0,0,33629
42027,2,77923,73508,4415,5.7,67654,5293,27750,19135,45345,158172,40055,36372,1066,0,0,77493
42029,2,286398,268513,17885,6.2,117326,18906,71857,70604,210289,534413,182372,128565,3565,0,0,314502
42031,2,17056,15681,1375,8.1,57844,2283,11650,5526,5907,37241,4678,14578,237,0,0,19493
42033,2,36272,33032,3240,8.9,59318,5633,27368,14071,11810,80562,9673,29203,546,0,0,39422
42035,2,17937,16415,1522,8.5,58892,2581,11446,5656,5324,37450,5502,11902,221,0,0,17625
42037,2,33909,31233,2676,7.9,59127,3591,19655,9686,10906,64727,10532,20098,541,0,0,31171
42039,2,38798,35441,3357,8.7,54774,5279,27538,13519,12484,83938,12924,28559,521,0,0,42004
42041,2,133628,124976,8652,6.5,81295,12049,56350,42807,72797,259469,62245,77212,2138,0,0,141595
42043,2,147089,134329,12760,8.7,67813,17000,64001,50105,68415,286401,78983,66408,1977,0,0,147368
42045,2,300050,273188,26862,9,83856,25164,106929,97330,163404,576830,206423,118532,2976,0,0,327931
42047,2,15462,13629,1833,11.9,57570,1477,11062,5676,4538,30990,4522,12140,244,0,0,16906
42049,2,129162,116813,12349,9.6,56489,13831,69954,47426,55240,270876,68286,66869,1928,0,0,137083
42051,2,56983,50439,6544,11.5,51494,9402,44466,22031,17723,128804,20444,41227,468,0,0,62139
42053,2,1820,1633,187,10.3,43362,854,3068,1306,720,6973,728,1882,36,0,0,2646
42055,2,78816,72991,5825,7.4,73709,10317,47881,25846,26471,155932,22422,57245,1116,0,0,80783
42057,2,7525,6650,875,11.6,64405,1138,5139,2533,1820,14556,1085,6824,68,0,0,7977
42059,2,16206,14669,1537,9.5,63082,2552,11223,6198,5342,35954,4911,12579,179,0,0,17669
42061,2,19883,17845,2038,10.2,58170,2960,15944,7137,5790,44092,5445,17061,286,0,0,22792
42063,2,38406,35017,3389,8.8,53040,4158,21854,13794,14662,83246,12634,28089,475,0,0,41198
42065,2,20431,18687,1744,8.5,54248,2709,16256,7022,5509,44492,4527,17960,337,0,0,22824
42067,2,12795,11903,892,7,62661,2752,8058,3160,2465,23509,2253,9649,141,0,0,12043
42069,2,105371,95479,9892,9.4,61168,12732,53977,39734,45914,215896,61991,52334,1085,0,0,115410
42071,2,286662,265741,20921,7.3,82434,48520,130089,81986,116943,552984,115847,160209,4183,0,0,280239
42073,2,40906,36779,4127,10.1,58730,4689,26610,16214,14016,86070,15978,29597,501,0,0,46076
42075,2,73275,67617,5658,7.7,69490,11845,41242,22265,23733,143257,23932,46731,989,0,0,71652
42077,2,195426,177177,18249,9.3,72590,25012,82865,63793,86009,374557,98288,84259,2166,0,0,184713
42079,2,159928,142862,17066,10.7,59358,21644,86188,66289,57994,325594,64873,86929,1519,0,0,153321
42081,2,56961,52070,4891,8.6,61729,7090,30753,22308,19836,114188,16971,41462,821,0,0,59254
42083,2,17377,15717,1660,9.6,58112,2141,13390,7248,5819,40432,5098,14083,285,0,0,19466
42085,2,48855,44240,4615,9.4,57702,6844,31854,20277,19738,110652,21067,36143,744,0,0,57954
42087,2,21409,19646,1763,8.2,57096,5058,15703,7280,4280,46143,4603,16670,229,0,0,21502
42089,2,83027,73723,9304,11.2,79824,11596,42466,32297,33384,168327,44060,38726,1043,0,0,83829
42091,2,456734,422938,33796,7.4,106743,30977,133819,125403,317581,856553,319511,185460,5186,0,0,510157
42093,2,9137,8584,553,6.1,76229,952,4501,2948,4856,18136,3771,5844,156,0,0,9771
42095,2,161933,147814,14119,8.7,75468,16308,73087,57660,74974,312951,85087,83854,2001,0,0,170942
42097,2,42943,39016,3927,9.1,57822,6656,31760,15451,12778,91647,12677,28952,654,0,0,42283
42099,2,24432,22821,1611,6.6,67834,3364,15386,8272,6176,45842,5950,18293,409,0,0,24652
42101,2,738204,648448,89756,12.2,56385,137248,324642,249868,377211,1603797,603790,132740,4847,0,0,741377
42103,2,25490,22873,2617,10.3,81886,3074,15174,13938,13064,58535,13019,19213,322,0,0,32554
42105,2,7311,6648,663,9.1,53935,1094,5577,3216,2036,16396,1726,7239,99,0,0,9064
42107,2,67209,61142,6067,9,63680,10425,46949,26904,19924,143049,20727,48871,1005,0,0,70603
42109,2,19722,18255,1467,7.4,62382,4184,11461,5314,5714,39736,4910,13983,247,0,0,19140
42111,2,33260,30203,3057,9.2,50516,5463,27087,12887,9495,74129,8654,31466,423,0,0,40543
42113,2,2623,2405,218,8.3,59957,399,2388,1126,963,5840,921,2619,55,0,0,3595
42115,2,20106,18672,1434,7.1,63413,2438,13239,7272,5654,38434,6236,15207,309,0,0,21752
42117,2,19175,17489,1686,8.8,61190,2366,12863,7895,6324,41045,4955,15742,378,0,0,21075
42119,2,19633,18346,1287,6.6,65521,3883,12052,5521,7706,42681,7475,12356,284,0,0,20115
42121,2,22488,20536,1952,8.7,52449,3150,17254,9490,7312,50454,7585,18569,374,0,0,26528
42123,2,18932,17439,1493,7.9,56707,1714,13080,7890,5484,38587,6066,14237,347,0,0,20650
42125,2,107178,97382,9796,9.1,70751,9054,53562,39568,49842,209349,45088,72080,1310,0,0,118478
42127,2,22465,20462,2003,8.9,56973,3381,17083,10470,8516,51155,9191,18637,261,0,0,28089
42129,2,179407,163499,15908,8.9,71152,12126,92727,74603,83845,354663,72129,130218,2350,0,0,204697
42131,2,13388,12290,1098,8.2,67643,1423,8581,4760,4044,26069,4704,9936,218,0,0,14858
42133,2,237305,218784,18521,7.8,79938,27804,122457,84239,87663,456438,88114,146733,3624,0,0,238471
8001,3,269887,249638,20249,7.5,89849,51641,98198,97726,96383,519572,134202,95657,3731,744,2406,236740
8003,3,8297,7806,491,5.9,53942,1089,2520,3454,2928,16376,3759,3813,90,23,123,7808
8005,3,359400,333007,26393,7.3,93525,36365,85041,124135,207006,655070,213607,127323,5423,926,2904,350183
8007,3,7028,6534,494,7,66025,506,2617,3323,4426,13359,3738,5189,120,19,78,9144
8009,3,2081,2035,46,2.2,47147,354,711,827,600,3506,317,1867,26,3,12,2225
8011,3,1786,1715,71,4,42958,815,1703,1200,614,5650,732,1503,15,6,18,2274
8013,3,190477,179548,10929,5.7,96584,9803,24148,45128,140031,330758,159089,42501,2539,697,1285,206111
8014,3,40347,37893,2454,6.1,114746,2092,6724,13236,31270,74112,29077,16295,772,104,384,46632
8015,3,9627,9058,569,5.9,75151,856,3469,4317,7193,19476,7160,6222,189,46,101,13718
8017,3,1082,1058,24,2.2,62891,103,336,500,303,1748,131,993,6,0,6,1136
8019,3,5954,5473,481,8.1,90350,406,1304,1555,4200,9397,3604,2754,113,23,54,6548
8021,3,3997,3788,209,5.2,49141,552,1673,1644,1174,7461,1959,2286,34,9,45,4333
8023,3,1809,1687,122,6.7,36970,278,801,859,748,3499,1311,741,15,4,23,2094
8025,3,1438,1364,74,5.1,49785,724,1972,1010,537,5922,437,1271,22,0,20,1750
8027,3,2082,1985,97,4.7,67766,143,838,1629,1422,4704,1112,2474,29,5,15,3635
8029,3,14132,13267,865,6.1,53910,2083,8449,6678,5947,31196,5887,13081,218,45,139,19370
8031,3,419155,387125,32030,7.6,87619,45478,77626,110242,292761,715522,313293,71618,4870,1230,2818,393829
8033,3,1133,1061,72,6.4,56695,75,760,646,486,2326,341,1089,5,1,13,1449
8035,3,195819,185433,10386,5.3,140768,5049,29025,64004,152978,357978,104653,121270,3715,432,1535,231605
8037,3,35321,32191,3130,8.9,105813,2728,7077,10049,20069,55731,18588,9892,377,78,205,29140
8039,3,14979,14334,645,4.3,120394,626,5028,7060,6898,26062,4490,14027,306,31,129,18983
8041,3,341374,318334,23040,6.7,82248,23818,95538,167170,200118,730395,161941,202828,9264,1135,3683,378851
8043,3,15192,14099,1093,7.2,57275,3627,15346,11371,8084,48939,7369,17517,397,59,215,25557
8045,3,31348,29365,1983,6.3,86566,4792,10161,12661,13854,61685,15427,14717,424,99,237,30904
8047,3,3923,3500,423,10.8,89805,283,678,1505,2311,5808,2223,1833,70,17,43,4186
8049,3,9228,8502,726,7.9,88059,692,3061,3390,5126,15717,4710,4883,174,31,72,9870
8051,3,11277,10582,695,6.2,88855,197,2101,2349,6761,16918,7132,3735,210,39,74,11190
8053,3,422,406,16,3.8,70675,0,96,317,367,788,255,353,10,1,13,632
8055,3,2591,2362,229,8.8,47968,375,1331,2151,1431,6820,2076,2203,71,12,44,4406
8057,3,933,897,36,3.9,62439,170,303,319,301,1379,175,681,12,2,6,876
8059,3,327035,305322,21713,6.6,102413,19320,79120,111873,216684,582910,218396,148417,6394,1089,3062,377358
8061,3,952,931,21,2.2,55573,86,258,406,195,1446,98,795,9,0,1,903
8063,3,4206,4096,110,2.6,56720,520,1444,1885,870,7087,662,3144,34,2,29,3871
8065,3,4795,4432,363,7.6,71326,418,1167,1213,2391,7436,2303,1497,101,23,37,3961
8067,3,30869,28885,1984,6.4,79358,1469,8584,11493,19307,55638,20548,14233,530,128,228,35667
8069,3,200965,189141,11824,5.9,88338,8186,41000,68481,126142,359066,126120,91489,4089,727,1913,224338
8071,3,6386,5945,441,6.9,49097,1106,3065,4641,1839,14555,3497,4284,86,17,77,7961
8073,3,2337,2240,97,4.2,54345,500,1728,886,1078,5675,470,2135,26,1,19,2651
8075,3,10853,10381,472,4.3,58976,1610,5723,4959,2866,21528,2218,8087,139,16,72,10532
8077,3,74581,69397,5184,7,69578,8499,31632,36954,34032,155703,31536,56894,1306,188,699,90623
8079,3,463,438,25,5.4,69794,15,104,192,373,865,317,427,3,0,9,756
8081,3,7147,6746,401,5.6,69088,769,3421,2963,1902,13292,1203,5670,97,7,49,7026
8083,3,12596,11755,841,6.7,58345,1725,5508,5969,5880,25849,5836,9306,192,33,133,15500
8085,3,21446,20125,1321,6.2,65736,2831,10520,9116,8853,42679,7687,16770,285,49,131,24922
8087,3,15878,15083,795,5,65599,2933,6179,6591,3346,29111,3876,9593,151,26,98,13744
8089,3,8165,7698,467,5.7,46607,1361,4034,4840,2370,18690,3605,5756,88,16,111,9576
8091,3,2475,2289,186,7.5,90837,115,609,1251,2315,4874,2365,1577,46,12,20,4020
8093,3,10954,10366,588,5.4,88020,389,2900,5539,5603,17390,4903,6991,238,56,103,12291
8095,3,2457,2395,62,2.5,68571,286,958,999,774,4530,486,1958,24,7,10,2485
8097,3,11101,10013,1088,9.8,111291,402,1501,2924,8570,17358,8989,2780,94,41,53,11957
8099,3,6107,5854,253,4.1,48832,1158,2230,2764,1428,11999,1458,4008,39,9,47,5561
8101,3,76006,70203,5803,7.6,58314,11218,35305,41622,29409,168162,43772,42252,1200,205,872,88301
8103,3,2900,2753,147,5.1,71630,293,1324,1569,1154,6529,561,3061,42,3,24,3691
8105,3,5348,4991,357,6.7,56877,882,2234,2589,2576,11539,2495,3660,66,11,73,6305
8107,3,15896,14723,1173,7.4,104407,657,3346,5042,9847,24829,10582,5925,236,37,96,16876
8109,3,3399,3175,224,6.6,45048,594,1331,1581,1554,6368,1884,1413,39,13,40,3389
8111,3,518,486,32,6.2,62732,0,161,134,264,705,342,202,7,2,9,562
8113,3,5414,4863,551,10.2,94387,108,862,1230,4123,8072,3924,1136,52,14,21,5147
8115,3,1153,1115,38,3.3,46980,145,424,634,454,2404,301,1121,8,1,15,1446
8117,3,21925,19904,2021,9.2,96984,1218,4095,6106,12604,31055,12631,5322,353,60,113,18479
8119,3,12812,11919,893,7,81466,753,4372,7056,7412,24710,5278,11241,267,25,128,16939
8121,3,2841,2758,83,2.9,61492,353,964,1246,849,4817,369,2595,25,5,14,3008
8123,3,164591,153885,10706,6.5,90770,25735,54520,71452,71248,328981,66060,96145,2895,340,1534,166974
8125,3,5547,5402,145,2.6,56075,1072,1765,2055,1716,9988,785,4107,52,2,35,4981
23001,4,54016,51281,2735,5.1,62848,5888,28414,25524,18317,111139,27617,29268,1105,603,768,59361
23003,4,29067,27574,1493,5.1,51562,4427,19467,15079,11233,67105,13956,21080,421,233,520,36210
23005,4,159948,152096,7852,4.9,88571,7861,45480,54148,117212,303069,128759,59584,2957,2154,2460,195914
23007,4,13661,12886,775,5.7,52159,1339,7726,6182,6504,29456,8069,8754,353,183,240,17599
23009,4,27591,26104,1487,5.4,63879,2158,12203,11651,16754,55478,19369,14982,549,380,396,35676
23011,4,61060,58248,2812,4.6,63191,4685,30834,27212,28043,123642,34902,34721,1406,730,856,72615
23013,4,19470,18488,982,5,65615,1792,9446,7891,12283,40607,15110,9982,355,248,337,26032
23015,4,16309,15504,805,4.9,72657,1423,8236,6929,11076,35237,12684,10256,420,199,298,23857
23017,4,25646,24072,1574,6.1,58842,3301,18421,12897,10050,57777,14755,17698,650,347,360,33810
23019,4,73858,70142,3716,5,60761,6062,35944,35059,33782,152199,37713,44825,1854,746,995,86133
23021,4,7125,6764,361,5.1,52529,1077,5041,4406,2935,16800,3517,6143,173,60,103,9996
23023,4,19152,18309,843,4.4,73587,1477,7841,7324,11619,36699,13528,9755,473,249,275,24280
23025,4,21910,20557,1353,6.2,55093,2721,15769,11847,7732,50477,10199,16644,466,230,334,27873
23027,4,19888,18938,950,4.8,63619,1886,9472,8169,10431,39607,12345,11196,402,347,276,24566
23029,4,13285,12510,775,5.8,55381,2051,8062,7304,5778,31095,6761,10194,232,143,240,17570
23031,4,109992,104512,5480,5,81315,7883,47887,49411,55574,211972,71189,54817,2189,1259,1588,131042
25001,5,110383,98557,11826,10.7,89774,6584,39009,50135,86284,228996,91994,55311,1856,638,1713,151512
25003,5,61441,55388,6053,9.9,71102,6037,28052,25035,36639,129026,51705,18064,927,465,610,71771
25005,5,300281,268029,32252,10.7,80702,56274,123280,104302,125347,579200,153377,119872,3667,1427,3021,281364
25007,5,9089,8151,938,10.3,89136,758,3526,3843,7817,20600,9914,2631,138,82,108,12873
25009,5,424418,380823,43595,10.3,92118,55892,138451,132657,239863,809829,267198,144837,5356,1899,5309,424599
25011,5,40030,36877,3153,7.9,69929,3292,14715,14327,21828,71029,30030,11201,692,380,700,43003
25013,5,226395,201794,24601,10.9,64030,41017,98467,87869,92525,465825,125948,87318,2971,1166,3390,220793
25015,5,88543,81884,6659,7.5,81878,4515,20363,23998,51116,162308,63362,22281,1086,768,835,88332
25017,5,902368,833448,68920,7.6,118494,75422,200893,194935,677768,1632002,617196,226956,10649,4484,10062,869347
25019,5,7169,6326,843,11.8,107613,419,1676,2254,6101,14255,5241,1914,81,41,61,7338
25021,5,390646,356557,34089,8.7,115770,28926,89085,99190,295617,725981,273312,125294,5191,1753,5492,411042
25023,5,283815,255751,28064,9.9,102647,25446,99548,96156,155019,530819,173630,121227,4310,1324,3379,303870
25025,5,456876,410348,46528,10.2,84548,68278,112975,94815,274881,797936,270522,58613,2959,1695,3451,337240
25027,5,442803,402081,40722,9.2,86078,52349,159762,155204,235094,862111,248773,171683,7130,2536,4799,434921
6001,6,818093,745114,72979,8.9,121190,132081,188746,256640,612435,1682353,617659,136309,6295,4664,5143,770070
6003,6,514,454,60,11.7,71646,44,218,420,496,1204,476,244,15,4,2,741
6005,6,14474,13118,1356,9.4,74356,2936,8604,13669,7295,40474,8153,13585,349,110,107,22304
6007,6,93234,84510,8724,9.4,63353,13179,30325,49524,43218,211632,50426,48730,1774,507,629,102066
6009,6,21353,19688,1665,7.8,73175,2375,11387,14013,7919,45292,10046,16518,359,125,116,27164
6011,6,10622,8877,1745,16.4,72963,3745,4138,4058,2029,21839,3239,4559,81,25,57,7961
6013,6,546310,497173,49137,9,119667,84241,143600,218931,364216,1165927,416386,152877,6116,2618,3319,581316
6015,6,9429,8519,910,9.7,57297,2870,5078,7741,4164,27743,4677,6461,150,78,87,11453
6017,6,90888,83202,7686,8.5,104859,7210,29405,50152,55065,191185,51621,61838,1871,460,369,116159
6019,6,445633,393753,51880,11.6,68693,135093,145274,200252,150566,1008654,193025,164464,4031,1474,1923,364917
6021,6,12760,11612,1148,9,63247,3665,5853,6038,3070,28917,3995,7063,128,34,77,11297
6023,6,59754,54656,5098,8.5,57660,7930,21726,33841,29998,136463,44768,21770,1132,625,548,68843
6025,6,71538,55364,16174,22.6,55523,31132,28625,33021,17804,179702,34678,20847,390,234,594,56743
6027,6,8319,7656,663,8,64332,1000,3809,4666,4422,19016,4634,4620,128,45,57,9484
6029,6,386344,336819,49525,12.8,65981,127772,154648,172599,103791,909235,133366,164484,3942,1074,2426,305292
6031,6,57004,50252,6752,11.8,63683,24617,26837,30792,13299,152486,18699,24072,604,125,361,43861
6033,6,28458,25682,2776,9.8,51848,6320,14112,19820,8683,68163,14941,13123,374,207,167,28812
6035,6,9412,8718,694,7.4,60308,4865,7067,8312,3082,32730,2799,8970,141,31,46,11987
6037,6,4974673,4363337,611336,12.3,82455,1336557,1402989,1720679,2451744,10014009,3028885,1145530,35452,21660,32838,4264365
6039,6,61945,55065,6880,11.1,71273,27033,23966,32120,17180,156255,23168,29378,621,217,348,53732
6041,6,130647,121786,8861,6.8,135960,13801,20478,40830,114844,262321,128288,24612,1536,724,670,155830
6043,6,7203,6402,801,11.1,66513,1276,2839,5144,4133,17131,4088,5950,155,39,48,10280
6045,6,37159,33785,3374,9.1,63621,9021,17033,22889,16248,91601,28782,13267,591,394,306,43340
6047,6,115496,101032,14464,12.5,65253,48206,49187,48747,25346,281202,48991,39397,941,388,837,90554
6049,6,3181,2901,280,8.8,51166,776,1772,2409,1481,8700,1150,3109,39,15,30,4343
6051,6,7883,6932,951,12.1,79105,1008,1699,3631,3312,13195,4013,2513,126,42,44,6738
6053,6,214206,190346,23860,11.1,91450,74469,57630,69303,77872,439035,113953,46299,1820,749,1102,163923
6055,6,68890,62735,6155,8.9,98580,14962,17073,28118,37684,138019,49817,20676,914,310,433,72150
6057,6,46778,42981,3797,8.1,80069,3907,16217,27840,31263,102241,36359,26779,919,345,348,64750
6059,6,1563811,1424333,139478,8.9,106047,287900,379386,580793,957048,3186989,814009,676498,17325,5819,8462,1522113
6061,6,187003,173074,13929,7.4,106114,14825,50097,101895,125284,404739,106869,122488,3948,779,1000,235084
6063,6,7628,6787,841,11,66725,915,4313,6868,3112,19790,4561,6445,153,39,62,11260
6065,6,1118880,1006179,112701,10.1,86350,270971,427314,517283,407007,2418185,528340,449144,9970,3372,6330,997156
6067,6,710803,643643,67160,9.4,83985,126456,238395,360417,361826,1585055,440808,259405,9770,3254,5203,718440
6069,6,32548,29328,3220,9.9,106560,7283,11429,15011,9727,64209,17628,10590,345,91,176,28830
6071,6,972807,879264,93543,9.6,78779,251976,391633,441352,322278,2181654,455859,366257,8791,3619,6604,841130
6073,6,1544298,1399329,144969,9.4,98365,249203,407232,657624,955076,3298634,964650,600094,21386,7421,8592,1602143
6075,6,559015,514683,44332,7.9,135366,74971,75776,116140,402351,873965,378156,56417,3299,2781,2900,443553
6077,6,334765,296348,38417,11.5,84738,98795,140117,157023,108910,779233,161137,121098,2929,1064,2264,288492
6079,6,134154,123695,10459,7.8,88578,15656,34582,65421,74574,282424,88310,67436,2408,794,766,159714
6081,6,438610,408287,30323,6.9,143795,52659,80468,121768,288258,764442,291496,75584,3554,1595,2022,374251
6083,6,218513,200743,17770,8.1,89334,49743,47074,81757,99882,448229,129963,65736,2416,939,1285,200339
6085,6,1023652,950754,72898,7.1,150502,142839,180768,266993,747586,1936259,617967,214612,9131,4040,4991,850741
6087,6,134838,121753,13085,9.7,99256,20676,27325,53418,78268,270861,114246,26937,1704,1062,888,144837
6089,6,73261,66741,6520,8.9,66312,10229,34012,54735,30011,182155,30000,60789,1277,368,496,92930
6091,6,1286,1179,107,8.3,63939,188,740,723,533,3236,730,1142,27,13,19,1931
6093,6,16967,15269,1698,10,51593,2873,8373,13508,7429,44076,9593,13290,318,116,155,23472
6095,6,201823,182148,19675,9.7,92711,34788,76361,113757,89064,453491,131639,69306,2475,958,1499,205877
6097,6,245738,225996,19742,8,96312,39389,65960,114487,133865,488863,199938,61825,3418,1499,1637,268317
6099,6,242015,215474,26541,11,75249,70118,103475,111518,67474,552878,105841,104145,2494,742,1732,214954
6101,6,45513,40347,5166,11.4,66071,13814,16102,22163,13189,99633,17367,24375,521,136,245,42644
6103,6,25674,23343,2331,9.1,58900,6165,12929,17373,8467,65829,8911,19141,403,90,186,28731
6105,6,4541,4168,373,8.2,49485,643,4973,4461,2219,16112,2851,3188,117,50,53,6259
6107,6,202466,175249,27217,13.4,64313,72985,76798,89859,45102,473117,66105,77579,1498,483,1220,146885
6109,6,20184,18045,2139,10.6,70108,2717,10532,18635,10038,55620,11978,17689,439,145,157,30408
6111,6,410076,374275,35801,8.7,101981,85061,112500,174417,206218,843843,251388,162207,5069,1766,2395,422825
6113,6,104826,96690,8136,7.8,82359,15097,22852,34898,57432,216403,67598,27292,1206,547,651,97294
6115,6,30713,27444,3269,10.6,63626,8120,14344,21000,9474,81575,11230,17676,510,124,256,29796
48001,7,22985,21676,1309,5.7,60800,5851,15884,13945,6069,57922,3955,15110,134,22,6,19227
48003,7,9173,8420,753,8.2,68998,2567,3577,2741,2214,18610,850,4943,60,10,0,5863
48005,7,35364,32661,2703,7.6,56825,8603,19383,18659,10248,86395,9143,25076,274,75,6,34574
48007,7,9149,8383,766,8.4,60523,1643,6152,6107,5307,23830,2916,9239,103,31,1,12290
48009,7,3962,3753,209,5.3,72062,551,2254,1775,1541,8560,446,4300,45,4,1,4796
48011,7,895,857,38,4.2,67548,77,443,493,276,1848,75,1035,2,0,0,1112
48013,7,21590,19743,1847,8.6,59817,6155,12445,8674,4914,48981,5876,12039,143,58,2,18118
48015,7,13430,12536,894,6.7,68630,2457,7280,6563,4985,30167,2951,11447,123,33,0,14554
48017,7,2381,2267,114,4.8,52751,1153,1177,1092,688,6904,409,1434,14,2,1,1860
48019,7,9921,9344,577,5.8,69284,1351,5048,6046,4256,20851,2505,10057,120,30,3,12715
48021,7,42647,40074,2573,6,73403,12131,19930,19207,15614,97216,15474,20516,531,128,16,36665
48023,7,1765,1705,60,3.4,49059,435,765,580,705,3465,183,1494,22,1,2,1702
48025,7,9798,8825,973,9.9,48176,3962,7937,7135,2461,31047,3288,6006,93,27,6,9420
48027,7,144433,134302,10131,7,62412,21027,61038,88235,63558,370647,57014,67893,1980,440,48,127375
48029,7,932280,861055,71225,7.6,65839,179802,324043,403050,417806,2009324,448452,308618,8837,2798,2113,770818
48031,7,6563,6310,253,3.9,82236,695,2386,2994,3177,11374,1911,5443,72,15,0,7441
48033,7,440,425,15,3.4,75186,24,138,127,158,631,16,397,2,1,0,416
48035,7,8226,7776,450,5.5,61048,1587,4147,4917,2785,18235,1561,7469,83,13,0,9126
48037,7,38608,35745,2863,7.4,52460,6231,22467,19924,13771,92893,10747,27116,300,91,7,38261
48039,7,178219,162907,15312,8.6,86197,27187,62340,81122,80643,372031,62228,90433,1860,417,46,154984
48041,7,116907,110672,6235,5.3,60355,13894,27097,31623,53753,233849,35349,47530,1812,252,118,85061
48043,7,4089,3818,271,6.6,52388,719,1215,1989,3245,9546,2258,2461,89,14,0,4822
48045,7,552,526,26,4.7,53208,188,277,314,183,1435,78,639,7,1,0,725
48047,7,2585,2309,276,10.7,35359,1684,1629,1101,745,7076,1470,998,10,6,0,2484
48049,7,15199,14213,986,6.5,53455,3270,9478,8612,5319,38095,2107,13698,134,24,6,15969
48051,7,8114,7597,517,6.4,62095,1956,4501,3648,3036,17642,1788,6743,63,15,0,8609
48053,7,23636,22510,1126,4.8,74897,3977,11146,11135,10567,49130,5639,18767,268,34,9,24717
48055,7,18909,17680,1229,6.5,60833,6204,12119,8023,5178,45883,6672,8031,190,47,33,14973
48057,7,11905,11210,695,5.8,62742,2442,4393,4743,2354,20106,2148,5641,61,6,0,7856
48059,7,5973,5647,326,5.5,63836,679,3584,3200,2341,13708,734,6012,71,15,0,6832
48061,7,170184,152951,17233,10.1,49583,72049,66219,63570,52232,421017,64063,49032,728,336,15,114174
48063,7,4977,4609,368,7.4,52919,1333,2966,2441,1653,12464,1394,3626,31,7,2,5060
48065,7,2869,2748,121,4.2,71902,257,1281,1422,1033,5807,297,2779,37,3,6,3122
48067,7,12194,11227,967,7.9,54276,2568,8341,5728,3553,28454,2795,11033,79,17,3,13927
48069,7,3265,3146,119,3.6,59958,1058,1390,1081,938,7371,466,1602,9,6,0,2083
48071,7,20311,18407,1904,9.4,102146,3288,8315,12510,7189,46571,3997,17353,250,50,2,21652
48073,7,21088,19412,1676,7.9,50351,6563,11311,9847,6275,50412,4210,15101,161,36,0,19508
48075,7,3010,2898,112,3.7,49200,792,1854,1719,566,6664,310,1943,18,8,0,2279
48077,7,4795,4530,265,5.5,66085,554,2785,2503,1830,10218,614,5069,46,12,3,5744
48079,7,1111,1031,80,7.2,45766,467,573,434,177,2547,177,809,11,3,0,1000
48081,7,1360,1285,75,5.5,43774,299,856,779,517,3285,178,1586,10,5,0,1779
48083,7,2859,2648,211,7.4,45834,651,1908,2125,1023,7684,451,3641,23,9,0,4124
48085,7,578797,542541,36256,6.3,113943,40904,106653,186092,406369,1064465,230945,252318,6075,1246,272,490856
48087,7,1066,1021,45,4.2,52093,423,353,496,448,2652,155,1048,12,1,2,1218
48089,7,9653,9116,537,5.6,59711,1645,5369,3794,3413,20557,2420,7472,50,19,14,9975
48091,7,77199,72493,4706,6.1,92979,7123,26693,37211,51887,161501,24826,62740,1106,191,29,88892
48093,7,5612,5303,309,5.5,51559,1484,3143,3085,1925,13594,853,5177,49,5,2,6086
48095,7,1328,1268,60,4.5,51191,536,1129,605,344,3303,197,1058,10,3,0,1268
48097,7,19209,17844,1365,7.1,66466,3337,8974,9651,6782,41668,3210,15596,156,26,8,18996
48099,7,23753,22179,1574,6.6,63428,4983,16131,22267,9949,83093,7565,15438,410,77,3,23493
48101,7,566,538,28,4.9,45351,191,232,309,204,1380,113,540,6,3,0,662
48103,7,1622,1400,222,13.7,67889,708,1190,586,416,4675,241,1247,10,4,1,1503
48105,7,1546,1408,138,8.9,71851,756,563,647,243,3098,344,1220,9,1,0,1574
48107,7,2288,2166,122,5.3,46457,711,1260,860,466,5133,527,1396,22,8,0,1953
48109,7,1126,1052,74,6.6,52160,429,765,151,262,2188,438,415,9,2,0,864
48111,7,3726,3623,103,2.8,61636,847,2010,848,691,7115,197,1389,18,5,0,1609
48113,7,1329323,1225658,103665,7.8,70871,310199,380799,412259,590082,2613539,598576,307076,9635,3667,550,919504
48115,7,4565,4166,399,8.7,48801,2225,2822,1827,1163,12456,808,2951,25,5,0,3789
48117,7,8472,8166,306,3.6,55565,3079,4413,2004,1273,18583,1264,3294,35,17,0,4610
48119,7,2389,2257,132,5.5,54587,377,1363,1279,733,5230,403,2162,24,3,0,2592
48121,7,511246,478345,32901,6.4,102711,41905,106536,179748,307742,906422,188695,222480,5421,1092,276,417964
48123,7,9175,8618,557,6.1,55525,2016,5647,3989,2178,19824,1494,6567,46,11,0,8118
48125,7,659,618,41,6.2,47074,179,425,361,228,1770,130,853,3,2,0,988
48127,7,6461,6049,412,6.4,44312,1324,1868,1407,571,8615,2264,1384,10,8,0,3666
48129,7,1412,1350,62,4.4,44866,364,723,767,357,3258,198,1438,11,1,0,1648
48131,7,4823,4236,587,12.2,40539,1729,2283,2074,456,9831,2575,2443,22,13,0,5053
48133,7,7318,6824,494,6.8,53351,1830,4056,3586,2705,17725,983,7237,60,12,1,8293
48135,7,82540,73412,9128,11.1,64868,21942,29882,29919,16326,165171,11367,32697,428,89,10,44591
48137,7,1234,1190,44,3.6,50752,199,209,275,239,1422,168,893,5,0,0,1066
48139,7,95045,89362,5683,6,89314,16294,35561,42317,37724,192455,27565,56717,954,220,37,85493
48141,7,361398,331382,30016,8.3,53441,105030,135101,164948,137640,865657,178126,84331,2746,1445,81,266729
48143,7,19921,18776,1145,5.7,60093,3319,6739,7257,8335,42545,2916,13684,218,35,3,16856
48145,7,6378,5989,389,6.1,47534,1838,3988,4513,1818,16968,1899,4177,44,13,0,6133
48147,7,16673,15884,789,4.7,60959,3422,9198,8025,5215,35662,2655,12171,155,23,3,15007
48149,7,11734,11180,554,4.7,70476,1769,6632,4820,4929,24435,2661,10171,83,26,0,12941
48151,7,1592,1521,71,4.5,57867,264,995,971,497,3672,352,1448,21,5,0,1826
48153,7,2490,2335,155,6.2,45784,911,1068,1006,599,5402,438,1584,15,2,0,2039
48155,7,574,551,23,4,47657,127,199,253,98,1095,99,445,6,1,0,551
48157,7,402550,371808,30742,7.6,105583,44909,97943,139416,274384,822779,195552,157718,3028,1091,125,357514
48159,7,4808,4551,257,5.3,56623,677,2016,2557,2177,10359,804,4161,36,8,0,5009
48161,7,6311,5783,528,8.4,56372,1870,4916,4941,2215,19435,1635,6991,67,18,0,8711
48163,7,9515,8975,540,5.7,46769,3329,4607,2090,1289,18385,2422,2823,23,11,0,5279
48165,7,9692,9146,546,5.6,62465,4922,3618,2304,950,21598,576,5355,54,10,1,5996
48167,7,163817,149429,14388,8.8,75947,24431,55646,78095,82424,350682,58842,93911,1913,393,1,155060
48169,7,2005,1868,137,6.8,50255,1197,1236,917,398,5816,231,1413,5,4,0,1653
48171,7,13218,12589,629,4.8,77013,2179,5020,5946,7183,26725,3176,12514,140,16,4,15850
48173,7,802,773,29,3.6,96533,97,112,260,311,1116,39,611,3,0,0,653
48175,7,3122,2879,243,7.8,62841,831,1553,1829,987,7012,877,3085,24,2,7,3995
48177,7,9489,8975,514,5.4,57523,2992,5081,3287,1644,19653,1948,5627,57,15,1,7648
48179,7,7744,7114,630,8.1,50648,2123,5034,4627,2145,21227,829,6840,97,16,0,7782
48181,7,63891,60126,3765,5.9,66141,9014,29398,33686,22436,135543,14506,44163,634,136,35,59474
48183,7,56255,51574,4681,8.3,60932,10678,22805,29115,18026,124239,14796,32493,551,113,29,47982
48185,7,11063,10168,895,8.1,61188,3790,6460,6660,4086,29268,2833,9432,118,30,1,12414
48187,7,80569,75621,4948,6.1,86043,12804,34243,35626,37009,172706,28805,47553,1023,211,27,77619
48189,7,11695,10904,791,6.8,49571,4969,6651,5230,3122,32522,2279,7177,97,31,2,9586
48191,7,1063,1001,62,5.8,40677,343,710,635,366,2825,168,995,4,1,1,1169
48193,7,3728,3558,170,4.6,59753,681,2074,1671,1419,8222,641,3616,52,40,2,4351
48195,7,2471,2385,86,3.5,69064,819,699,728,981,5285,166,1849,27,3,2,2047
48197,7,1701,1626,75,4.4,49539,356,847,912,374,3549,241,1330,9,0,0,1580
48199,7,25184,22932,2252,8.9,70432,3905,14431,12314,8033,56231,3474,23858,276,27,0,27635
48201,7,2274838,2070430,204408,9,68748,538499,698362,799676,1037321,4731145,918193,700630,16819,5129,47,1640818
48203,7,28966,26683,2283,7.9,64636,4990,14942,15721,10352,68839,7908,21466,294,42,7,29717
48205,7,2608,2556,52,2,84165,677,1396,1004,923,5382,195,1868,14,1,0,2078
48207,7,2663,2549,114,4.3,48587,652,1368,1008,879,5416,353,1840,15,6,0,2214
48209,7,123296,115559,7737,6.3,89074,13551,33812,45153,66658,241067,59524,47680,1735,418,38,109395
48211,7,1790,1708,82,4.6,73212,342,727,600,540,3382,206,1486,25,3,0,1720
48213,7,36984,34602,2382,6.4,62843,7389,19875,19980,11968,82150,7060,28911,264,75,7,36317
48215,7,359152,317207,41945,11.7,48825,155271,127485,120846,102969,870781,128199,90527,1261,865,32,220884
48217,7,16232,15208,1024,6.3,57566,3281,8575,8610,4631,35874,2860,11926,119,26,0,14931
48219,7,10637,9790,847,8,56923,2754,3897,4536,2508,21537,1482,6536,61,16,5,8100
48221,7,27918,26073,1845,6.6,75545,3612,13021,14910,15123,61598,5648,26496,319,71,7,32541
48223,7,17422,16531,891,5.1,64249,3875,8586,7707,5051,36787,3046,12719,143,31,2,15941
48225,7,10052,9524,528,5.3,49741,2826,6155,4792,2531,22066,2314,7060,56,7,1,9438
48227,7,13410,12319,1091,8.1,59598,4274,7548,7449,3492,34860,2069,8054,89,28,1,10241
48229,7,1844,1694,150,8.1,39582,877,547,493,271,3202,371,779,10,5,0,1165
48231,7,43158,40313,2845,6.6,68019,9465,23227,21340,15145,99956,8906,29163,434,71,23,38597
48233,7,8479,7871,608,7.2,65019,1899,4292,5072,2138,20617,965,7681,115,10,2,8773
48235,7,756,711,45,6,77768,115,277,439,236,1513,120,759,8,2,0,889
48237,7,3388,3150,238,7,54132,1160,1942,1857,914,8472,331,3418,24,9,0,3782
48239,7,7265,6844,421,5.8,61953,1755,3797,3125,1635,14988,1033,5231,53,23,13,6353
48241,7,12817,11376,1441,11.2,50763,2655,10492,6762,2858,32980,2954,12542,105,7,3,15611
48243,7,957,908,49,5.1,58285,187,191,598,427,1996,501,784,17,3,0,1305
48245,7,104564,92024,12540,12,55065,25619,54892,56007,32964,256526,46073,47570,897,199,20,94759
48247,7,1872,1693,179,9.6,43782,511,985,454,456,4838,1197,833,4,2,0,2036
48249,7,16080,13989,2091,13,48252,5138,9214,6606,3750,38891,6119,7453,69,28,0,13669
48251,7,83252,77847,5405,6.5,76747,16148,42022,36240,29069,179927,16464,54628,771,142,15,72020
48253,7,5613,5216,397,7.1,51894,2796,5711,4617,1659,19663,999,5660,63,19,0,6741
48255,7,6980,6541,439,6.3,61860,2396,3860,2559,1681,14710,1234,3968,30,17,3,5252
48257,7,69207,64784,4423,6.4,92814,13849,29435,32434,25641,145310,18405,37624,528,146,15,56718
48259,7,22127,21003,1124,5.1,120238,2097,5388,9077,15989,44279,6020,20083,289,46,14,26452
48261,7,179,169,10,5.6,43274,25,9,8,5,350,65,127,1,1,0,194
48263,7,461,443,18,3.9,58118,57,142,214,152,753,47,411,1,3,0,462
48265,7,21644,20377,1267,5.9,59619,3783,11354,11738,12195,52598,6524,20879,283,51,8,27745
48267,7,1828,1736,92,5,51851,567,984,948,862,4286,284,1987,17,4,0,2292
48269,7,236,232,4,1.7,87856,31,39,28,56,265,8,151,0,0,0,159
48271,7,1307,1229,78,6,52609,288,635,1130,498,3129,446,1144,11,2,0,1603
48273,7,13209,12090,1119,8.5,51342,2807,5697,4735,4118,31040,5314,5504,97,29,0,10944
48275,7,1444,1363,81,5.6,47207,341,854,753,360,3353,265,1180,7,4,0,1456
48277,7,23496,21983,1513,6.4,62620,4110,11613,11548,7068,50088,4458,16760,172,28,24,21442
48279,7,5192,4921,271,5.2,53008,1829,2759,2350,1153,13045,840,3521,40,7,2,4410
48281,7,9009,8525,484,5.4,67917,1525,4668,6097,3394,21627,2144,8086,145,24,0,10399
48283,7,3723,3472,251,6.7,40555,1625,1896,611,364,6664,1052,1335,12,7,0,2406
48285,7,8383,7944,439,5.2,58400,1833,5358,4071,2976,20337,1333,8804,46,8,6,10197
48287,7,9132,8680,452,4.9,65911,2118,4778,3351,2357,17478,1750,6255,65,16,1,8087
48289,7,6073,5598,475,7.8,56749,1556,4350,3525,1939,15719,1072,7523,57,14,8,8674
48291,7,34302,30712,3590,10.5,61880,13269,23101,17357,6802,91628,5785,23302,218,29,0,29334
48293,7,8292,7700,592,7.1,51357,2247,4883,5449,2975,22146,2213,6789,66,27,0,9095
48295,7,1519,1456,63,4.1,70236,306,527,550,471,3059,131,1205,17,0,0,1353
48297,7,5147,4760,387,7.5,58576,1922,2448,2801,1152,11335,819,4199,30,6,0,5054
48299,7,8436,7950,486,5.8,59528,1412,4800,5488,5778,21243,2465,10079,99,16,1,12660
48301,7,296,291,5,1.7,94716,3,11,38,0,64,4,60,2,0,0,66
48303,7,156589,147580,9009,5.8,59138,21117,48235,56524,62913,310639,40017,78861,1617,276,46,120817
48305,7,2736,2586,150,5.5,56754,639,1034,1134,901,5596,428,1853,10,2,0,2293
48307,7,3203,2961,242,7.6,45915,927,1775,1621,1054,7630,490,2904,36,6,0,3436
48309,7,118990,111569,7421,6.2,63160,19302,44266,53538,45027,260579,36688,59543,1297,243,101,97872
48311,7,716,696,20,2.8,67525,41,156,104,53,600,53,460,2,1,0,516
48313,7,4460,4140,320,7.2,53906,1809,3520,2481,1328,13455,1088,4169,30,10,1,5298
48315,7,4226,3874,352,8.3,47720,950,2592,2419,1135,9725,1339,3470,47,8,0,4864
48317,7,2551,2395,156,6.1,73315,521,1337,781,571,5237,288,1857,13,2,0,2160
48319,7,1723,1627,96,5.6,59129,438,580,647,1116,3953,457,1991,19,2,5,2474
48321,7,16454,14720,1734,10.5,58380,4154,6943,7497,5482,36255,3733,9845,115,33,1,13727
48323,7,24229,20559,3670,15.1,43407,10762,9455,8018,5111,57887,8332,6881,73,60,0,15346
48325,7,21299,19948,1351,6.3,70313,5008,11624,11121,7900,50748,6773,15642,184,45,13,22657
48327,7,861,817,44,5.1,44145,338,363,420,333,1962,197,823,6,2,0,1028
48329,7,98346,90423,7923,8.1,81187,14805,25292,34199,33291,169983,12329,45624,777,126,3,58859
48331,7,9665,8970,695,7.2,54667,2314,6962,4749,3401,24754,2496,7984,72,24,2,10578
48333,7,1875,1798,77,4.1,58068,363,1042,1076,969,4456,271,2217,15,2,0,2505
48335,7,2338,2153,185,7.9,48378,1018,2294,1926,847,8990,397,2170,11,1,0,2579
48337,7,9047,8446,601,6.6,57076,1895,5454,4514,2576,19965,1097,8615,78,24,5,9819
48339,7,289558,267945,21613,7.5,95241,42242,100062,124303,162678,620443,74377,193382,3166,526,92,271543
48341,7,10543,10148,395,3.7,66583,3739,4383,2911,1511,21358,1062,4359,66,21,0,5508
48343,7,4846,4301,545,11.2,49847,1066,2956,2936,1280,11973,1669,3872,36,10,0,5587
48345,7,431,412,19,4.4,46320,136,337,270,210,1063,46,604,2,0,0,652
48347,7,27784,25955,1829,6.6,51708,5630,11044,11193,10050,64653,9000,17378,302,83,22,26785
48349,7,23259,21818,1441,6.2,50822,7048,9918,11339,5827,52624,5101,13800,167,53,2,19123
48351,7,4970,4415,555,11.2,47804,1373,4377,2528,550,12217,1173,4882,34,5,0,6094
48353,7,7042,6664,378,5.4,50579,1581,3487,3201,1315,14738,1162,4131,53,10,1,5357
48355,7,164180,149531,14649,8.9,60250,34448,68366,75577,55365,353178,60925,64617,1404,368,8,127322
48357,7,4021,3786,235,5.8,69383,1138,2190,1502,1134,10015,302,2812,37,3,2,3156
48359,7,892,857,35,3.9,66411,152,300,480,315,1758,81,917,10,1,0,1009
48361,7,35658,31878,3780,10.6,63901,5103,20800,20638,10074,84808,6357,29186,376,51,24,35994
48363,7,13148,12222,926,7,56809,2758,7128,6299,3717,28409,2178,10179,101,27,4,12489
48365,7,9385,8596,789,8.4,59772,2311,4730,5649,2762,22491,2057,9326,57,11,0,11451
48367,7,69418,65376,4042,5.8,95277,10150,27795,35298,33809,148222,13017,62045,880,158,28,76128
48369,7,4838,4714,124,2.6,57786,1683,1736,1721,1030,9869,488,2135,23,4,0,2650
48371,7,6393,5865,528,8.3,54003,2123,3993,2660,1360,15193,1382,3215,50,21,0,4668
48373,7,18323,16708,1615,8.8,58894,6813,14434,11143,5015,50123,5387,18573,171,50,5,24186
48375,7,53070,50128,2942,5.5,51028,16868,22906,21935,12941,118525,9921,22820,454,126,16,33337
48377,7,3192,2717,475,14.9,43666,1274,822,899,758,6131,1463,721,21,12,0,2217
48379,7,5984,5702,282,4.7,45419,958,2989,3094,2367,12164,842,5155,43,13,0,6053
48381,7,72890,69640,3250,4.5,77066,6051,22700,35976,30533,140753,12802,50796,910,129,37,64674
48383,7,1799,1623,176,9.8,83195,196,893,395,305,3385,172,942,7,3,0,1124
48385,7,1080,1010,70,6.5,49467,255,802,514,372,2758,320,1643,14,5,0,1982
48387,7,5095,4770,325,6.4,47081,1106,3432,2675,1337,11587,1246,4517,36,7,0,5806
48389,7,8785,8153,632,7.2,53969,2405,3356,2032,575,14748,1395,2254,30,8,2,3689
48391,7,3038,2787,251,8.3,50936,816,1749,1488,649,6741,1108,2210,26,21,1,3366
48393,7,401,383,18,4.5,70814,13,202,192,115,827,17,529,4,0,0,550
48395,7,7294,6825,469,6.4,57796,1766,4349,3261,2218,16757,2374,5646,66,13,0,8099
48397,7,54536,51302,3234,5.9,124291,4438,14469,23896,33593,107819,16412,36726,611,121,21,53891
48399,7,4519,4296,223,4.9,52729,944,2522,2074,1305,9900,552,3807,39,11,0,4409
48401,7,21911,20299,1612,7.4,55085,5482,11906,12386,6474,52214,4629,16534,155,50,9,21377
48403,7,3891,3469,422,10.8,50564,980,2930,2455,1381,9894,669,4784,27,7,4,5491
48405,7,3014,2724,290,9.6,49591,1059,2552,1505,666,7918,980,3007,13,2,0,4002
48407,7,11587,10646,941,8.1,57855,3057,7983,5496,3108,27402,2337,10161,101,39,2,12640
48409,7,29355,26353,3002,10.2,62919,7339,15844,14507,7852,68755,8988,16516,291,93,3,25891
48411,7,2185,2072,113,5.2,51350,638,1547,1036,891,5730,287,2308,7,0,0,2602
48413,7,1208,1124,84,7,54168,322,455,510,411,2451,211,940,6,2,0,1159
48415,7,6200,5689,511,8.2,60387,1614,3455,3876,1948,16932,818,4983,53,15,1,5870
48417,7,1773,1679,94,5.3,64690,167,555,718,762,3105,130,1484,10,4,0,1628
48419,7,11194,10428,766,6.8,51551,2755,5904,4916,2161,24022,2068,7975,37,4,3,10087
48421,7,1301,1261,40,3.1,73395,349,398,434,407,2782,91,886,9,5,1,992
48423,7,108049,100705,7344,6.8,67978,18900,39161,55731,43686,233479,29615,69080,1126,254,14,100089
48425,7,4262,3983,279,6.5,75568,587,2215,2287,1694,9205,768,4105,56,10,8,4947
48427,7,26050,21481,4569,17.5,35758,14659,9219,7955,4882,65920,9123,8247,92,63,0,17525
48429,7,4015,3770,245,6.1,50710,1058,2019,2113,1155,9101,397,3385,16,2,0,3800
48431,7,557,521,36,6.5,75895,95,303,196,193,1372,51,584,1,3,0,639
48433,7,570,541,29,5.1,53153,125,336,233,114,1245,116,615,4,1,0,736
48435,7,1210,1091,119,9.8,68838,413,849,551,332,3372,322,1222,9,4,0,1557
48437,7,2512,2381,131,5.2,52148,881,1871,825,902,6971,478,1845,22,10,0,2355
48439,7,1075554,995932,79622,7.4,76285,178658,327514,401695,479206,2110640,411567,409741,10368,2617,404,834697
48441,7,65896,62293,3603,5.5,61798,8357,25997,28529,25697,143208,14588,39547,827,150,23,55135
48443,7,379,362,17,4.5,47969,42,224,211,228,760,119,334,3,2,0,458
48445,7,4796,4444,352,7.3,46998,1644,2601,2332,810,11831,757,2812,33,10,0,3612
48447,7,636,606,30,4.7,50997,83,391,379,284,1440,82,806,5,1,0,894
48449,7,13219,12328,891,6.7,58411,4481,6906,5174,3015,31247,2856,7570,94,19,2,10541
48451,7,53580,50179,3401,6.3,60348,10056,21723,26858,19668,120003,12239,32313,546,96,16,45210
48453,7,734290,687548,46742,6.4,95151,78078,132542,199835,512222,1290188,435860,161337,8905,2094,379,608575
48455,7,5291,4860,431,8.1,49629,1117,4045,3352,1609,13602,1323,5579,25,11,0,6938
48457,7,7334,6608,726,9.9,50722,2469,6269,4132,1751,19798,1403,8194,52,11,0,9660
48459,7,17468,16121,1347,7.7,59690,3770,9106,10766,5011,40892,2877,15809,179,22,5,18892
48461,7,1808,1705,103,5.7,61607,412,1019,598,196,3308,170,1178,13,7,0,1368
48463,7,11266,10541,725,6.4,48427,3370,4018,4993,3127,24564,4073,6174,66,29,2,10344
48465,7,21464,19672,1792,8.3,52593,7227,8637,6941,6184,47586,6771,8284,170,47,8,15280
48467,7,26006,24405,1601,6.2,57706,5408,13876,15585,7758,59541,3516,22270,175,33,35,26029
48469,7,40803,37401,3402,8.3,67905,8968,18598,20625,11813,91319,10380,23358,339,103,8,34188
48471,7,23982,22258,1724,7.2,53301,7984,18162,15022,11230,76400,7884,15375,287,63,3,23612
48473,7,24376,22518,1858,7.6,75223,5501,10022,9633,9104,56794,8191,14260,201,82,0,22734
48475,7,6143,5560,583,9.5,60775,1350,2865,2145,761,11644,764,3241,29,26,0,4060
48477,7,15179,14320,859,5.7,66911,2365,6966,7639,7625,35805,4261,12959,178,20,9,17427
48479,7,115773,105964,9809,8.5,56289,46038,33772,40664,31912,267114,41820,25898,446,233,0,68397
48481,7,21268,19822,1446,6.8,57487,4428,8644,9204,5302,41570,4694,11926,105,36,0,16761
48483,7,2185,2052,133,6.1,55713,417,1119,1178,658,4990,168,2159,7,3,0,2337
48485,7,55338,51659,3679,6.6,56634,10043,26239,26823,20851,129350,13161,32069,675,125,10,46040
48487,7,4894,4607,287,5.9,52983,1616,2699,2819,1504,12887,956,3524,33,11,0,4524
48489,7,6584,5795,789,12,41648,4172,4476,2706,1575,20164,3108,2441,0,0,0,5549
48491,7,323000,304159,18841,5.8,101891,25456,77360,126441,206612,609017,143795,139729,4998,790,243,289555
48493,7,24370,22973,1397,5.7,79432,3674,10747,11644,9288,49753,6350,18463,151,39,10,25013
48495,7,3961,3587,374,9.4,69775,1229,1685,1313,470,7791,358,1753,14,1,0,2126
48497,7,32090,29988,2102,6.6,80096,6545,16507,15823,10110,68632,4973,27032,310,47,3,32365
48499,7,17815,16633,1182,6.6,57504,4482,10640,11122,7515,44843,3509,19049,175,40,6,22779
48501,7,3501,3081,420,12,62748,1092,1360,1409,639,7694,420,2174,31,6,0,2631
48503,7,7724,7316,408,5.3,58297,1322,4048,4144,2936,17867,1034,7110,76,18,1,8239
48505,7,4664,4093,571,12.2,39403,2855,2323,1711,1055,13889,1826,2033,11,4,0,3874
48507,7,3388,2904,484,14.3,36237,1519,1884,1758,545,9670,2864,1490,13,12,0,4379
